#####################################################################################################
#                                                                                                   #
#                                                                                                   #
#                                                                                                   #
#                                                                                                   #
#           ######################                                                                  #
#           #                    #                                                                  #
#############                    #                                                                  #
#                                                                                                   #
#                                #                                                                  #
#                                #                                                                  #
#                 ################                                                                  #
#                 #                                                                                 #
#                 #                                                                                 #
#                 #                                                                                 #
###################                                                                                 #
#                                                                                                   #
#                                                                                                   #
#                                                                                                   #
#                                                                                                   #
#####################################################################################################
