#####################################################
#                                                   #
#                                                   #
#                                                   #
#                                                   #
#             #                                     #
#             #                                     #
#             #                                     #
#                                                   #
#                                                   #
#                                                   #
#                                                   #
#                                                   #
#                                                   #
#                                                   #
#                                                   #
#                                                   #
#                                                   #
#                                                   #
#                                                   #
#####################################################