#####################################################################################################
#                                                                                                   #
#                                                                                                   #
#                                                                                                   #
#                                                          ~~~~~~~~~~~~                             #
#           ######################                          ~~~~~~~~~~~~                            #
#           #                    #                             ~~~~~~~~~~~~                         #
#############                    #                                    ~~~~~~~~~~                    #
#                                                                                                   #
#                                #                                                                  #
#                                #                                                                  #
#                 ################                                                                  #
#                 #                     ^^^^^^^^^                                                   #
#                 #                     ^^^^^^^^^                                                   #
#                 #                     ^^^^^^^^^                                                   #
###################                                                                                 #
#                                                                                                   #
#                                                                                                   #
#                                                                                                   #
#                                                                                                   #
#####################################################################################################
